11111111111
1000000E001
1C000011111
1100C000111
11C0000P001
11111111111
