11111111111
10000000001
10O00011111
1100C000111
1100000P001
11111111111
