1111111111111111111111111111111111111111
1000011110000000000000000000000000000001
11000011110000000CC00000000C000000000001
1000011110000000CC0000000C00000000000001
1000000010000000000000000000000000000001
100001100000000E0C00CC00E000000000000001
1000011110000000000000000000000000000001
1000011110000000000CC000E00C000000000001
100001111000000000000000000000E000000001
10EE11E00P000000EEEE0000EEE000000CC00001
1000000000000000000000000000010000000001
1000011110000000000000000000000000000001
1000011110000000C00000000000000000000001
1000000010000000000000000000000000000001
1000011000000000000E00000000E00000000001
1000010001111000000000000000000000000001
100001110001100000000000E000000000000001
100001110001100000000000000000E000000001
10EE11E0000000000000EEEEEEE0000000000001
1000000000000000000000000000000000000001
1000000000000000000000000000000000000011
1111111111111111111111111111111111111111
