111111111111111111111111111111111111
100000000000000000000000001000000001
1C0001111100000000000000000000000001
1C000111110000000CC000C0000000000001
1C0000000100000000000000000000000001
1C00011000000000E0C00CC00E0000000001
1C0001111100000000000000000000000001
1C00011111000000CC000E00C00000000001
1C00011111000000CCCCCC00000E00000001
10EE11E000P000000EEEEEEE00000CC00001
111111111111111111111111111111111111
