11111111111
100X000E001
10000011111
1100C000111
1100000P001
11111111111
